1111111
101N001
1000001
1100101
1111111