NO ./textures/so_bad.xpm

EA ./textures/so_cool.xpm
         SO          ./textures/so_normal.xpm
        
WE ./textures/so_it.xpm
F  30       ,  100,     25
C 220, 100     , 30


   1111111       111111
   1100001       100001
   1100011       100001
   100011       100001
111100111       100111
1000000011111111101
1000100010000000001
1100000000100001011
10010100111000010N1
1000000000000000001
1111111111111111111