NO ./image/Wall1.xpm
EA ./image/Wall2.xpm
SO          ./image/Wall3.xpm
        
WE ./image/Wall4.xpm
F  30       ,  100,20
C 220, 100     , 30


    111111       1111111    
    100001       11000E1
   1100011      1100001
   100001       1000001
111110011       100111
1000000011111111101
1000100010000000001
1100000000100001011
1001010011100001011
1000000000000000001111111111
1000000000000000000000000001
1111111111111111111111111111