N1111
E2222
S3333
N4444

1          111111
1    0 110     01
100      0001

11 001  01
11    1   1111
