NO   ./textures/so_bad.xpm
EA          ./textures/so_cool.xpm

SO  ./textures/so_normal.xpm
    WE          ./textures/so_it.xpm

11111        111111
1000111111111100011
1000100010000000001
1100010000000001011
10010001110000010N1
1111111111111111111
