

1          111111
1    0 000     01
100      0001

11 001  01





11    1   1111
