NO ./image/Wall1.xpm
EA ./image/Wall2.xpm
SO          ./image/Wall3.xpm
        
WE ./image/Wall4.xpm
F  43       ,  143,29
C  	231,        181,   233


1111111111111111111111111111
1000000011111111100000000001
1000100010000000000000000001
1100000000100001000000000011
1001010011001000000000000011
1000000000000N00001111111111
1000000000000000000000000001
1111111111111111111111111111