NO ./image/Wall1.xpm
EA ./image/Wall2.xpm
SO ./image/door.xpm
WE ./image/kitchen.xpm
F  43, 143, 29
C  231, 181, 233
1111111111111111
1100000000000001
10001000100000111
11000000001000W11
10010100011111111
10000011111
10000000001
11111111111