NO ./image/wall.xpm
SA ./image/wall.xpm
SO          ./image/wall.xpm
        
WE ./image/wall.xpm
F  30       ,  100,20
C 220, 100     , 30


1111111111111111111111111111
1000000011111111100000000001
1000100010000000000000000001
1100000000100001000000000011
1001010011001000000000000011
100000000N000000001111111111
1000000000000000000000000001
1111111111111111111111111111