NO ./image/door.xpm
EA ./image/door.xpm
SO ./image/door.xpm
WE ./image/door.xpm
F  43, 143, 29
C  231, 181, 233
1111111111111111
10000000000000011
10000000000000001
10000000000000001
10000000001111111
10000000001
100000000N1
11111111111