NO ./image/Wall1.xpm

EA ./image/Wall2.xpm
SO 	    ./image/door.xpm	 

WE  	   ./image/kitchen.xpm  	   
F  43       ,  143,29   
C  	231,   	181,     233


1111111111111111111111111111
10000000000000000000000000S1
1000000000000000000000000001
1000000000000000000000000001
1000000000000000000000000001
1000000000000000000000000001
1000000000000000000000000001
1111111111111111111111111111